11111111111111111111
100000000000CC000001
1E000000000000000001
100000C0000000000001
10000000001000000001
1000000001P100000001
11111111111111111111