11111111111111111
1000P00000C000001
11111111E11111111
100000C0000000001
11111111111111111
11111111111111111
