11111111111
10001101C01
10C01001C01
10E00001111
1P001000001
11111111111