11111
1P001
10C01
10E012
10001
11111