11111111111
1P001100C01
10C01000c01
10E00000001
10001000001
11111111111