11111
1P001
10C01
10E01
10001
11111