1111111111111
1E01000000001
1C00010111001
1P00110100001
1111111111111