1111111111111
10010000000C1
1000011111001
1P0011E000001
10000C1111001
1000011111001
10C0011111001
1000011111001
1000011111001
100C011111001
1000011111001
10000111110C1
1000011111001
1000C11111001
1000011111001
1000011111001
1000011111001
1111111111111