111111111111111111111111111111111111111111111111111111111111111111111111111111111111111111111111111
10010000000C110000C111100000000C111100110000C111100110010000000C110010000000C110010000000C100000001
100100100000000000111000011111001100001101100000C001111100110C0011111001000001111001000001011000001
100100100001111100111000011111001100001101100110000111100110000111100100000110000100000110000001101
100100100001111100111000011111001100001101100110000111100110000111100100000110100100000100100001101
100100100001111100111000011111001100001101100110000111100110000111100100000100100100000101100001101
100100100001111100111000011111001100001101100110000111100110000111100100000101100100000001100001101
100100100001111100111000011111001100001101100110000111100110000111100100000101100100000111100001101
100100100001111100111000011111001100001101100110000111100110000111100100000100100100000111100001101
100100100001111100111000011111001100001101100110000111100110000111100100000110100100000111100001101
100100100001111100111000011111001100001101100110000111100110000000000000000100100100000111100001101
100100100001111100000000011111000000000001100110000111100110000111100100000001100000000111100001101
1C000111110011000011111001100C011111001100001111100000000111110C11000011110001P0011E000001100001101
111111111111111111111111111111111111111111111111111111111111111111111111111111111111111111111111111