11111111111111111111111111111111111111111111111111111111111111111111111111111
1000000000000000000000000000000000000000000000P000C00000E00000000000000000001
10000000000000000000000000000000000000000000000000000000000000000000000000001
10000000000000000000000000000000000000000000000000000000000000000000000000001
11111111111111111111111111111111111111111111111111111111111111111111111111111