














111111111111111111
100000C0C0E0000001
111000000000000001
11C000000000P00001
111111111111111111







