





11111
10001




1PCE1
11111




