1111111111111111111111111
1000000001C00000010000001
1111110111111111111011001
100100000C00000C000000001
101C1000P0000000000E00001
1111111111111111111111111