1111111111111111111111111
1000000001E00000010000001
1111110111111111111011001
100000000C00000C000000001
10000000P0000000000000001
1111111111111111111111111