111111111111111111
1000000000000000E1
100000000001111111
1P0000000000000111
1000CCC00000000011
111111111111111111